* * * * * * * * * * * * * * * * * * * * * * * * * * * *
* * * * * * * * * * * * * * * * * * * * * * * * * * * *
* * * * * $ * * * * * * * * * * * * * * * * * * * * * *
* * * * * * * * * * * * * * * * * $ * * * * * * * * * *
* * * * * * * * * * * * * * * * * * * * * * * * * * * *
* * * * * * * * ^ * * * * * * * * * * * * * * * * * * *
* * * * * ^ ^ ^ ^ ^ ^ ^ ^ ^ ^ ^ ^ ^ * * * * * * * * * *
$ * * * * * ^ ^ ^ ^ ^ ^ ^ ^ ^ ^ ^ ^ ^ * * * * * * * * *
* * * * * * * * * * * * * * * ^ * * * * * * * $ * * * *
* * * * * * * * * * * * * * * * * * * * * * * * * * * *
* * * $ * * * * * * * * * * * * * * * * * * * * * * * *
* * * * * * * * * * * * * * * * * * * * * * * * * * * *
* * * * * * * * * * * * * * * * * * * * * * * * * * * *
* * * * * * * * $ * * * * * * * * * * * * * * * * * * *
* * * * * * * * * * * * * * * * * * * * * $ * * * * * *
* * * * * * * * * * * * * * * * * * * * * * * * * * * *