* * * * * * * * * * * * * * * * * * * * * * * * * * * *
* * * * * * * * * * * * * * * * * * * * * *! * * * * * *
* * * * * $ * * * * * * *! * * * * * * * * * * * * * * *
* * * * * * * *! * * * * * * * * * $ * * * * * * * * * *
* * * * * * * * * * * * * * * * * * * * * * * * * * * *
* * * *! * * * * ^ * * * * * * * * * * * * * * * * * * *
* * * * * ^ ^ ^ ^ ^ ^ ^ ^ ^ ^ ^ ^ ^ * * * * * * * * * *
$ * * * * * ^ ^ ^ ^ ^ ^ ^ ^ ^ ^ ^ ^ ^ * * * * * * * * *
* * * * * * * * * * * * * * * ^ * * * * * * * $ * * * *
* * * * * *! * * * * * *! * * * * * *! * * * * * * * * * *
* * * $ * * * * * * * * * * * * * * * * * * * * * * * *
* * * * * * * * * * *! * * * * *! * * * * * * *! * * * * *
* * * * * * * * * * * * * * * * * * * * * * * * * * * *
* * * * * * * * $ * * * * * * * * * * * * * * * * * * *
* * * * * * * * * * * * * * * * * * * * * $ * * * * * *
* * * * * * * * * * * * * * * * * * * * * * * * * * * *